0 10 10 -1 -1 -1 -1 -1 -1 -1 -1 -1 -1 -1 -1
10 0 10 -1 20 -1 -1 -1 -1 -1 -1 -1 -1 -1 -1
10 10 0 -1 -1 20 -1 -1 -1 -1 -1 -1 -1 -1 -1
-1 -1 -1 0 30 -1 -1 20 -1 -1 -1 -1 -1 -1 -1
-1 20 -1 30 0 10 -1 -1 30 -1 -1 -1 -1 -1 -1
-1 -1 20 -1 10 0 30 -1 -1 30 -1 -1 -1 -1 -1
-1 -1 -1 -1 -1 30 0 -1 -1 -1 20 -1 -1 -1 -1
-1 -1 -1 20 -1 -1 -1 0 30 -1 -1 -1 -1 -1 -1
-1 -1 -1 -1 30 -1 -1 30 0 20 -1 50 -1 -1 -1
-1 -1 -1 -1 -1 30 -1 -1 20 0 30 -1 50 -1 -1
-1 -1 -1 -1 -1 -1 20 -1 -1 30 0 -1 -1 -1 -1
-1 -1 -1 -1 -1 -1 -1 -1 50 -1 -1 0 10 50 -1
-1 -1 -1 -1 -1 -1 -1 -1 -1 50 -1 10 0 -1 50
-1 -1 -1 -1 -1 -1 -1 -1 -1 -1 -1 50 -1 0 20
-1 -1 -1 -1 -1 -1 -1 -1 -1 -1 -1 -1 50 20 0
