0 40 -1 -1 -1 -1 -1 40 -1 -1 -1 -1 -1 -1 -1
40 0 20 -1 20 -1 -1 -1 -1 -1 -1 -1 -1 -1 -1
-1 20 0 20 -1 20 -1 -1 -1 -1 -1 -1 -1 -1 -1
-1 -1 20 0 -1 -1 20 -1 -1 -1 -1 -1 -1 -1 -1
-1 20 -1 -1 0 20 -1 -1 -1 20 -1 -1 -1 -1 -1
-1 -1 20 -1 20 0 20 -1 -1 -1 -1 -1 -1 -1 -1
-1 -1 -1 20 -1 20 0 -1 -1 -1 20 -1 -1 -1 -1
40 -1 -1 -1 -1 -1 -1 0 20 -1 -1 40 -1 -1 -1
-1 -1 -1 -1 -1 -1 -1 20 0 20 -1 -1 -1 -1 -1
-1 -1 -1 -1 20 -1 -1 -1 20 0 40 -1 -1 40 -1
-1 -1 -1 -1 -1 -1 20 -1 -1 40 0 -1 -1 -1 40
-1 -1 -1 -1 -1 -1 -1 40 -1 -1 -1 0 20 -1 -1
-1 -1 -1 -1 -1 -1 -1 -1 40 -1 -1 20 0 20 -1
-1 -1 -1 -1 -1 -1 -1 -1 -1 40 -1 -1 20 0 20
-1 -1 -1 -1 -1 -1 -1 -1 -1 -1 40 -1 -1 20 0